DSASAAAASSSSSDAASAASAAADSAAASSASAASSSADSASASASAA
*************************************
***************   *******************
*** *********   *       *************
*** ********  *********   ** E*******
***   ****** ************ *a ********
***** *****  ************  a*********
***** ***** *************  **********
*****  *    ************   **********
****** * *************** K **********
******   ************ b    **********
********a***********  ****a    ******
******     *********Pb***************
****** *** *********c    ************
*** ******   ******S      ***********
***  ******* * ba    * **  **********
****  b  *** * *****   *** **********
********a *** b****  ***** **********
*********  *  ***** ******a**********
********   b  *****b******  *********
*******  **** ***** *******  ********
******* *****  **** ******** ********
**************c**   ******** ********
**************  a **********  *******
************** a************* *******
************** **********************
*************************************