ADSSASAADSDAADADSASAASSAASWWASSSSSASASSSSSSADSADAD
*********************************
***************      ********* E*
**************  **** ********* **
*************  *****      *** a**
***********   *********** * b ***
*******   c  ************ *    K*
**********    *********** *c ** *
********** **c   ********c***** *
********** *****     ****  ***  *
********** ********* ***** *** **
*********  ****** ** ***  P    **
******* b ******* ** *** *S******
***************** ** *** ********
****** *********  ****** ********
******  ******** *******c********
*******  ******       ** ********
********    **  *****    ********
*********** a  ******  **********
************   ******    ********
**********   *aa **   ** b    ***
********** *****    *********c **
********   ******  **************
*****************  **************
*********************************