DWSADSDDSAWADSSSSDADSS
********************
**********   **** **
**E     a  *   ** **
**     *****b     **
** cK c***   **   **
*** *  *** ******  *
*** * **** ******* *
*** *a**** ******* *
* c Pa**** ******* *
***  S***  ******* *
***** **** *********
***** **** *********
***** ****   *******
*****      * *******
*****  *****b **** *
*****  ******  *** *
****   *******  ** *
***  * ********c * *
*** ** *********   *
*** **  *****  c  **
***a***       ******
********************