SASASASSSSSSASAAAWDDWDWAAASASAAASAAAAASSA
**************************************************
************************  ************************
**********************    ****************E*******
********************** **c***************  *******
********************** **    ***********  ********
*********         **** ***** ********** c*********
*****************   ** ***** ********** **********
******************* ** ***** **********a**********
******************* ** ***** ********** **********
******************* ** *****     c     b**********
*******************    ***********      **********
********************   ********  b  K   **********
*******************   a***Pc   a***    ***********
*******************    *** *********** ***********
*****************    *  *S *********** ***********
****************   **** **************   *********
**************** ******   ************** *********
**************** *****    ************** *********
***************b *******    ************ *********
*************** *********   ************ *********
**************  ***********  *********** *********
****    *****   ************     *****************
******* ****  ****************** *****************
*******    * *******************a*****************
**********    ******************  ****************
*********** * *******************  *********   ***
*********** *   ******************      **   *****
**********  *** *********************** ** *******
********   ****  *****************         *******
*******  ******* ***************** ***** *********
******  ******** ****************  ***** *********
****** ********* *************   b****** *********
****************  ***********  ********* *********
*****************  *********  ********** *********
******************    ****   *********** *********
*********************      ***********************
***********************  *************************
***********************  *************************
**************************************************