DDSDWWAAAASSDSD
******************
** bK  **  *******
** Eb  **    a  **
**P *  * c**  ****
***cS**  * abb****
****    *  *  ****
****** ****** ****
****** ***********
****   ****  a ***
* *  **     ******
* a ****** a******
***      c     ***
******************